0000000000000000000000000
0000000000000000000000000
0000000000000000000000000
0000000000000000000000000
0000000000000000000000000
0000000000000000000000000
0000000000000000000000000
0000000000000000000000000
0000000001111111000000000
0000000001000001000000000
0000000001001111000000000
0000000001001000000000000
0000000001001111000000000
0000000001000001000000000
0000000001000001000000000
0000001111000001000000000
1111111000000001111111111
0000000000000000000000000
0000000000000000000000000
0000000000000000000000000
0000000000000000000000000
0000000000000000000000000
0000000000000000000000000
0000000000000000000000000
0000000000000000000000000