00000000000000000000000000000000000000000000000000
11111111111110000000000000000000000000000000000000
00000000000010000000000000000000000000000000000000
00000000000010000000000000000000000000000000000000
00000000000010000000000000000000000000000000000000
00000000000010000000000000000000000000000000000000
00000000000010000000000000000000000000000000000000
00000000000010000000000000000000000000000000000000
00000000000010000000000000000000000000000000000000
00000000000010000000000000000000000000000000000000
00000000000010000000000000000000000000000000000000
00000000000010000000000000000000000000000000000000
00000000000010000000000000000000000000000000000000
00000000000010000000000000000000000000000000000000
00000000000010000000000000000000000000000000000000
00000000000010000000000000000000000000000000000000
00000000000010000000000000000000000000000000000000
00000000000010000000000000000000000000000000000000
00000000000010000000000000000000000000000000000000
00000000000010000000000000000000000000000000000000
00000000000010000000000000000000000000000000000000
00000000000010000000000000000000000000000000000000
00000000000010000000000000000000000000000000000000
00000000000010000000000000000000000000000000000000
00000000000010000000000000000000000000000000000000
00000000000010000001111110000000000000000000000000
00000000000010000001000010000000000000000000000000
00000000000010000001000010000000000000000000000000
00000000000010000001000010000000000000000000000000
00000000000010000001000010000000000000000000000000
00000000000010000001000010000000000000000000000000
00000000000010000001000010000000000000000000000000
00000000000010000001000010000000000000000000000000
00000000000011111111000010000000000000000000000000
00000000000000000000000010000000000000000000000000
00000000000000000000000010000000000000000000000000
00000000000000000000000010000000000000000000000000
00000000000000000000000010000000000000000000000000
00000000000000000000000010000111111110000000000000
00000000000000000000000010000100000010000000000000
00000000000000000000000010000100000010000000000000
00000000000000000000000010000100000010000000000000
00000000000000000000000010000100000010000000000000
00000000000000000000000010000100000010000000000000
00000000000000000000000011111100000010000000000000
00000000000000000000000000000000000010000000000000
00000000000000000000000000000000000010000000000000
00000000000000000000000000000000000010000000000000
00000000000000000000000000000000000011111111111111
00000000000000000000000000000000000000000000000000


